10 16
xxxxxxxxxxxxxxxx
x..............x
x.....x........x
x.....x........x
x.....x.........
.........x......
.........x.....x
x........x.....x
x..............x
xxxxxxxxxxxxxxxx
